aboutir	v	Causation/
afin_de	prep	FR_Means_for_purpose/
afin_que	conj	FR_Means_for_purpose/
au_motif_que	conj	FR_Reason/
au_point_de	prep	Causation/
au_point_que	conj	Causation/
au_vu_de	prep	Evidence/FR_Reason/
avec_l'_objectif_de	prep	FR_Means_for_purpose/
c'_est_dire_que	conj	Evidence/
c'_est_que	conj	Evidence/Explaining_the_facts/
car	c	Causation/Evidence/FR_Cause_enunciation/
causer	v	Causation/
d'_après	prep	Evidence/
d'_autant_moins_que	conj	Causation/Evidence/
d'_autant_plus_que	conj	Causation/Evidence/
d'_autant_que	conj	Causation/Evidence/
dans_l'_optique_de	prep	FR_Means_for_purpose/
dans_la_mesure_où	conj	Causation/Evidence/
dans_le_but_de	prep	FR_Means_for_purpose/
dans_un_but_de	prep	FR_Means_for_purpose/
de_façon_que	conj	Causation/
de_façon_à	prep	FR_Means_for_purpose/
de_manière_à	prep	FR_Means_for_purpose/
de_sorte_que	conj	Causation/
de_telle_manière_que	conj	Causation/
du_fait_de	prep	Causation/Evidence/
du_fait_que	conj	Causation/Evidence/
dès_lors_que	conj	Evidence/
déclencher	v	FR_Cause_to_start-Launch_process/
en_raison_de	prep	Causation/Evidence/
en_vertu_de	prep	FR_Reason/
en_vue_de	prep	FR_Means_for_purpose/
faute_de	prep	Causation/
grâce_à	prep	Causation/
induire	v	Causation/
infliger	v	Causation/
jusqu'_à_ce_que	conj	Causation/
par_la_faute_de	prep	Causation/
parce_que	conj	Causation/Evidence/
pour_cause_de	prep	Causation/
pour_que	conj	FR_Means_for_purpose/
preuve_que	conj	Evidence/
provoquer	v	Causation/
puisque	conj	Evidence/FR_Reason/
si_bien_que	conj	Causation/
sous_l'_effet_de	prep	Causation/FR_Contingency-Objective_influence/
sur_l'_injonction_de	prep	Response/
sur_la_demande_de	prep	Response/
sur_ordre_de	prep	Response/
tant_et_si_bien_que	conj	Causation/
vu_que	conj	Evidence/FR_Reason/
à_cause_de	prep	Causation/
à_ce_point_que	conj	Causation/
à_cet_effet	prep	FR_Means_for_purpose/
à_des_fins	prep	FR_Means_for_purpose/
à_des_fins_de	prep	FR_Means_for_purpose/
à_défaut_de	prep	Causation/
à_force_de	prep	Causation/
à_l'_origine_de	prep	Causation/
à_la_demande_de	prep	Response/
à_la_suite_de	prep	Causation/
à_tel_point_que	conj	Causation/
étant_donné	prep	Evidence/
étant_donné_que	conj	Evidence/
